R 800 600




NO ../txtr6.xpm
SO ../pink.xpm
WE ../blue.xpm
EA ../green2.xpm
S ../elexir.xpm

F 040,000,080
C 100,150,255


111111111111     11111111111111111111
1001001001001       100000000100000011
 10100000010011111111001000000000111111
100000000000100000000100000000001
100000000000000000000000000000001
100000000011111111100000000000001
100000000000010000100000111100001
1000000000000100001000001  100001
100000000000010000000000111100001
100100010000010000100010000000001
101000000100S11111100000000111111
111111111111001111111111111
            101
1111111111111011111111111111
12000000011010000100000000001
120000000100111000000000001111111
1200000000000000011100000000001
100000000000000001 100000000001
 1111111111111111   1111111111
