R 800 600




NO ../txtr6.xpm
SO ../pink.xpm
WE ../blue.xpm
EA ../green2.xpm
S ../elexir.xpm

F 040,000,080
C 100,150,255


111111111111111
100000000000001
1000W0000002001
120000000020201
100000000000001
111111111111111