R 1250 800





NO ./txtrs/blue.xpm
SO ./txtrs/pink.xpm
WE ./txtrs/fl1.xpm


EA ./txtrs/txtr6.xpm
S ./txtrs/donuts.xpm

F 040,0,80

C 070,130,255


111111111111111111111111
1000000000000110000000011111
1000000002000000000000001111
100000000000000000200000011111
10020200000000000000000111
1000020200000001110000001
100000000000001  10000001
111111111111111  10000001
                 100000011111111111111
                 100000000000000000001
        111111111100000000000002000201
        100000000000200000020000000001
        100002000000000000000000000001
        100000000020000000000000000111
11111111100000010000000001000200000001
10000000000000000000000000001000011001
10000020000010000020000000000100000001
10002000000010000000000N00000000000001
11111111111111111111111111111111111111
