R 800 600

NO ./path_to_the_north_texture
SO ./path_to_the_south_texture
WE ./path_to_the_west_texture
EA ./path_to_the_east_texture
S ./path_to_the_sprite_texture

F 040,000,080
C 100,150,255

111111111111111111111111111111111
100100100100110000000010000000001
101000000100110000000010000111111
100000000000010000000010000000001
100000000000000000000000000000001
100000000011111111100000000000001
100000000000010000100000000000001
100000000000010000100000000000001
100000000000010000000000000000001
100100010000010000100010000000001
101000000100011111100000000111111
120000000110100001000000000000001
120000000100111000000000001111111
1200000000000000000000000N0000001
111111111111111111111111111111111