R 1250 800





NO ./txtrs/txtr6.xpm
SO ./txtrs/pink.xpm
WE ./txtrs/blue.xpm
EA ./txtrs/fl1.xpm
S ./txtrs/donuts.xpm

F 040,000,080
C 070,130,255


1111111111111111111111111
100000000000011000000001
1000000000000000000000001
1000000000000000002000001
10020200000000000000000111
1000020200000001110000001
100000000000001  10000001
111111111111111  10000001
                 100000011111111111111
                 100000000000000000001
        111111111100000000000002000201
        100000000000200000020000000001
        100002000000000000000000000001
        100000000000000000000000000111
11111111100000000010000000000000000001
10000000000000000000000000001000011001
10000000000010000000000000000100000001
10000000000010000000000N00000000000001
11111111111111111111111111111111111111
