R 800 600




NO ../txtr6.xpm
SO ../pink.xpm
WE ../blue.xpm
EA ../green2.xpm
S ../elexir.xpm

F 040,000,080
C 100,150,255


11111111111111111111111111111111
10000000000000000000000000000001
100000000001000000001101001010011
100000100000010011000001000000011
10111000110000000000000000001111
10100000000100000000011001000001
10001100000000011100001100111101
100000000000001000011001000001001
1011101011000010001111100100010001
1000000000000000000000110100100011
1110000011001000000100000010111001
1000100000000000000000000000000011
10111010101100000001000100011011
1000001010110000001110010001 1
1111111010110010000100110001
1000100010000111000001100001
101110001001100001010100011
101010011010S00010011100011
1000101100000001001111100001
101110100001100000000000001
1011101001111000000110000001
1000101011  1111101001100001
100000001       100000011101
100001111       11111000001
111111              1000001
                    11110101
                       10101
                       10001
                       11111