R 1200 400





NO ../txtr6.xpm
SO ../pink.xpm
WE ../blue.xpm
EA ../green2.xpm
S ../donuts.xpm

F 040,000,080
C 100,150,255


11111111111111111111111
10000000000000S000000001
100000000020000000000111
12000000002020111111111
100000000000001
111111111111111